00000000000000000000
00000000000000000000
00000011111111100000
00000012211222100000
00000012223222100000
00000013211123100000
00000012144412100000
00000112144412110000
00000123223223210000
00000122222122510000
00000111111111110000
00000000000000000000