00000000000000000000
00000000000000000000
00000000000000000000
00001111001111100000
00011221001222100000
00012321111322100000
00012234444232100000
00011222212521100000
00001111111111000000
00000000000000000000
00000000000000000000
00000000000000000000