00000000000000000000
01111111111111100000
01222221422222110000
01122222223222211000
01222222222322211100
01111222211212141100
00001231222222522100
00001222211222221100
00001111142221111000
00000000111111000000
00000000000000000000
00000000000000000000
